20 30
78 -88 72 65 9 -52 -19 18 -29 82 55 4 -71 14 26 -75 76 68 -57 96 42 37 3 68 -1 -55 -51 -3 25 -1
-92 -31 34 -10 6 17 5 73 3 -9 -82 -43 -23 -78 72 36 -24 93 60 88 54 41 -71 49 -100 -38 -8 -9 -68 42
3 -39 -100 -66 65 -69 10 93 11 -38 86 -100 65 -46 -74 83 4 21 34 84 -18 63 40 -37 -57 26 -5 62 -3 24
-17 38 -53 -100 -35 27 -98 54 82 -48 33 89 -25 -54 31 -87 -47 -70 -98 72 -45 43 27 -40 100 13 -73 -74 74 -62
-38 -69 63 21 -16 54 -78 -26 -91 49 -62 -47 85 -38 -61 -15 -42 2 -5 -95 87 -22 -13 -34 11 -26 30 -18 56 -81
80 58 1 -49 -57 -1 -31 85 -46 11 -66 97 -36 -11 17 -41 -42 39 43 -79 66 51 -84 46 -6 -53 -78 -41 -99 -66
-56 -16 -37 -72 -56 -79 -96 -18 35 9 8 -66 82 -78 -45 -67 -87 33 -81 -44 20 -54 14 -46 -71 -16 -10 9 -78 -45
86 -56 48 81 85 -30 -66 -13 -67 59 -31 15 45 12 -33 -62 13 78 -76 73 -42 -97 51 -98 -55 43 76 28 -89 -12
-42 -93 -36 91 -68 -62 79 24 32 -6 -6 -25 -34 8 11 -64 -63 -27 -71 -17 -37 -53 61 -67 61 -57 87 36 85 -3
-91 -33 -49 13 44 59 -68 82 81 -35 -18 -33 84 -32 56 -54 93 76 -96 -8 -58 2 -92 70 78 -54 27 -79 25 -64
47 41 -74 -97 80 -31 16 -30 83 6 -97 90 -98 -81 -71 27 -81 22 11 -56 10 -97 6 -25 -9 -65 65 50 82 76
-20 40 26 37 -12 31 57 -1 2 -5 -18 85 58 37 -76 82 -34 67 -89 76 -19 -54 79 35 -42 -74 -94 -21 -90 -88
32 54 64 17 61 34 62 -17 42 88 64 -23 -10 -41 10 -53 -80 -16 -60 -25 72 19 84 -77 74 -24 -35 1 43 -39
-44 13 67 3 16 -99 -99 69 -59 28 -86 86 37 -17 65 68 -19 -40 14 22 -14 13 18 96 41 -20 -86 92 51 -37
-73 57 53 80 59 -23 -27 54 87 -46 20 -25 -1 -89 60 15 46 35 -56 60 65 -22 -98 42 -33 -91 36 59 -11 -72
-82 -39 63 -86 59 -8 55 98 51 80 74 98 -27 70 90 -52 -45 80 28 72 -59 -53 39 17 -85 29 -45 57 67 -19
43 -64 14 77 94 83 -3 -71 80 -90 -64 -47 65 -24 -68 17 -75 -72 73 29 -84 69 13 -30 -41 28 -17 11 7 12
-28 -75 6 -40 24 59 88 54 -52 -42 -5 -51 -39 86 -68 97 27 10 2 43 60 95 -14 -28 69 -76 27 18 77 69
-4 90 -45 -24 19 -19 56 69 14 70 -82 68 -85 44 38 36 66 36 -53 19 -6 -66 -43 62 -27 10 -26 23 -19 11
9 81 82 5 99 -60 74 -34 -10 -63 73 -100 -64 1 32 61 95 -89 50 80 100 13 -49 95 -28 -20 -98 -65 86 11